13 31
###############################
#p              b             #
#         #x                  #
#                             #
#                    *        #
#       *         #           #
# 1            f              #
#                 #           #
#                             #
#                 #           #
#      s                      #
#                             #
###############################